gameId,onBlueTeam,blueWins,blueWardsPlaced,blueWardKills,blueFirstBlood,blueKills,blueDeaths,blueAssists,blueEliteMonsterKills,blueDragonKills,blueHeraldKills,blueTowerKills,blueTotalGold,blueAvgLvl,blueTotalExp,blueTotalMinionsKilled,blueGoldDiff,blueExpDiff,onRedTeam,redWins,redWardsPlaced,redWardKills,redFirstBlood,redKills,redDeaths,redAssists,redEliteMonsterKills,redDragonKills,redHeraldKills,redTowerKills,redTotalGold,redAvgLvl,redTotalExp,redTotalMinionsKilled,redGoldDiff,redExpDiff
3488933243,0,1,17,8,0,8,5,8,0,0,0,1,24495,9.6,30435,310,2990,4453,1,0,27,0,1,5,8,4,3,2,1,0,21505,8.8,25982,296,-2990,-4453
3488835829,1,1,25,5,1,9,3,11,3,2,1,0,21992,8.6,25892,295,871,-1141,0,0,27,5,0,3,9,4,0,0,0,0,21121,9,27033,315,-871,1141
3488803459,0,1,16,7,1,10,5,13,1,1,0,2,26169,8.8,27850,302,6757,6762,1,0,17,2,0,5,10,6,1,1,0,0,19412,7.6,21088,193,-6757,-6762
3488799309,0,0,18,1,1,4,8,2,0,0,0,0,21143,8.8,26332,278,-1112,-2060,1,1,21,2,0,8,4,9,2,2,0,0,22255,9,28392,274,1112,2060
3488773005,0,1,21,10,0,10,9,10,2,1,1,0,22401,8.8,26670,273,-1238,-1210,1,0,27,6,1,9,10,11,0,0,0,0,23639,9,27880,287,1238,1210
3488709559,1,1,23,3,0,13,8,15,1,1,0,0,24860,9,28513,279,2492,2196,0,0,22,1,1,8,13,8,1,1,0,0,22368,8.8,26317,290,-2492,-2196
3488704737,0,1,24,6,0,13,12,10,0,0,0,0,23681,8.6,24442,227,466,212,1,0,24,7,1,12,13,13,1,1,0,0,23215,8.2,24230,237,-466,-212
3488710497,1,0,26,3,1,13,2,14,3,2,1,1,23945,8.8,27423,233,3167,1931,0,1,22,5,0,2,13,5,0,0,0,0,20778,8.6,25492,298,-3167,-1931
3488645450,0,0,20,2,1,9,13,5,0,0,0,2,23006,8.4,25312,283,-2271,-3120,1,1,19,6,0,13,9,14,1,1,0,0,25277,9,28432,303,2271,3120
3487953932,1,1,27,6,1,15,5,18,3,2,1,0,24226,8.8,26341,278,3332,1812,0,0,24,5,0,5,15,4,0,0,0,0,20894,8.4,24529,297,-3332,-1812
3487878273,0,1,19,5,1,8,12,9,1,1,0,1,23433,9,27542,288,-1938,-976,1,0,25,1,0,12,8,18,2,1,1,0,25371,8.8,28518,302,1938,976
3487860926,0,0,20,4,1,15,4,15,2,2,0,2,27899,9.2,30527,336,6733,5241,1,1,26,1,0,4,15,4,0,0,0,0,21166,8.2,25286,263,-6733,-5241
3487776848,1,1,21,6,0,9,7,12,1,1,0,0,25321,9,26983,287,2172,625,0,0,20,2,1,7,9,5,2,1,1,1,23149,8.4,26358,300,-2172,-625
3487773440,1,0,22,4,0,2,12,1,1,0,1,1,19769,8.6,25590,269,-6182,-2065,0,1,24,4,1,12,2,18,2,2,0,1,25951,9.2,27655,296,6182,2065
3487749848,0,0,21,7,0,6,8,6,0,0,0,1,22171,8.4,26519,330,-1999,-735,1,1,28,5,1,8,6,8,3,2,1,1,24170,8.8,27254,274,1999,735
3487744984,1,1,23,3,0,12,11,11,1,1,0,0,24703,9.4,29281,301,803,-359,0,0,16,4,1,11,12,7,0,0,0,0,23900,9.4,29640,286,-803,359
3487732511,1,0,17,4,0,5,13,5,0,0,0,0,20517,8.8,25816,260,-6498,-4360,0,1,19,5,1,13,5,10,3,2,1,1,27015,9.2,30176,315,6498,4360
3487618560,1,1,21,1,1,10,9,8,2,1,1,1,24134,8.8,27336,267,709,44,0,0,20,4,0,9,10,12,1,1,0,0,23425,8.8,27292,268,-709,-44
3483577855,0,0,21,1,0,8,7,2,2,1,1,1,24279,9,29124,361,1506,1109,1,1,16,3,1,7,8,4,0,0,0,0,22773,8.8,28015,269,-1506,-1109
3483571306,1,0,24,8,0,11,6,12,1,1,0,0,22514,9,27929,237,-34,465,0,1,24,7,1,6,11,4,0,0,0,0,22548,9,27464,323,34,-465
3481576904,1,1,21,4,1,20,8,29,2,1,1,0,27617,8.4,25056,233,4623,1759,0,0,22,5,0,8,20,6,1,1,0,1,22994,8.2,23297,239,-4623,-1759
3481496946,1,1,23,4,1,11,11,6,1,0,1,1,24120,8.8,27318,273,-525,-1653,0,0,21,6,0,11,11,9,1,1,0,0,24645,9.2,28971,305,525,1653
3480970788,0,0,21,4,1,11,20,13,0,0,0,0,23951,8.8,27260,265,-6229,-2889,1,1,27,4,0,20,11,18,3,2,1,2,30180,9.4,30149,288,6229,2889
3480608966,1,1,19,8,1,15,3,17,2,1,1,2,28463,9.6,30666,286,7983,5240,0,0,19,4,0,3,15,2,0,0,0,0,20480,8.6,25426,282,-7983,-5240
3480572625,1,1,26,5,0,10,8,13,1,0,1,1,23973,8.8,27139,272,863,-2260,0,0,25,1,1,8,10,6,1,1,0,0,23110,9.2,29399,313,-863,2260
3480497485,0,0,17,3,0,3,10,3,2,1,1,0,22495,8.8,26457,319,-2306,-3492,1,1,24,4,1,10,3,17,1,1,0,1,24801,9.2,29949,314,2306,3492
3480483185,0,0,17,5,0,3,11,4,0,0,0,0,19946,8.2,24175,284,-5585,-4855,1,1,26,1,1,11,3,17,2,2,0,0,25531,9.2,29030,341,5585,4855
3480448010,0,0,20,4,0,4,10,4,0,0,0,0,21478,8.8,27339,321,-4579,-1901,1,1,23,3,1,10,4,7,3,2,1,1,26057,9,29240,305,4579,1901
3480443759,0,1,23,6,1,16,3,16,1,1,0,1,28149,9.8,31176,349,8081,5155,1,0,20,5,0,3,16,1,0,0,0,0,20068,8.6,26021,268,-8081,-5155
3480338376,0,0,21,6,1,4,6,5,1,1,0,0,19521,8.4,24759,252,-2930,-3378,1,1,19,3,0,6,4,5,1,1,0,0,22451,9.2,28137,314,2930,3378
3479613283,0,0,19,5,1,6,15,4,0,0,0,0,22303,8.8,26964,299,-3003,-3171,1,1,18,4,0,15,6,12,2,2,0,1,25306,9.2,30135,256,3003,3171
3479610090,1,1,18,6,1,10,8,13,2,2,0,0,23246,9.2,28278,255,-167,-21,0,0,22,2,0,8,10,7,1,0,1,0,23413,9.2,28299,307,167,21
3479527556,0,1,15,6,0,12,5,11,2,1,1,1,27169,9.4,31031,368,6223,4592,1,0,25,3,1,5,12,3,0,0,0,0,20946,8.8,26439,263,-6223,-4592
3479513882,0,0,22,1,0,3,4,2,1,1,0,0,19921,8.4,25737,281,-1221,-1005,1,1,24,1,1,4,3,4,1,0,1,0,21142,8.8,26742,305,1221,1005
3479469183,1,0,20,1,1,7,6,8,0,0,0,0,22319,9.4,28748,306,-1585,-1722,0,1,21,3,0,6,7,7,2,2,0,0,23904,9.4,30470,374,1585,1722
3479461944,1,0,21,3,0,14,14,12,2,1,1,0,25179,9.2,28382,278,1086,1013,0,1,19,4,1,14,14,12,1,1,0,0,24093,8.8,27369,245,-1086,-1013
3478928848,0,0,24,5,0,4,9,4,2,1,1,0,19519,8.6,26512,236,-4517,-2006,1,1,22,5,1,9,4,7,1,1,0,1,24036,9,28518,282,4517,2006
3478926115,0,1,22,6,0,10,11,8,2,2,0,0,23891,9,28738,282,181,-293,1,0,23,3,1,11,10,9,0,0,0,0,23710,9,29031,279,-181,293
3478913122,1,1,21,2,1,12,6,15,1,1,0,0,24211,9.2,29142,299,1415,1874,0,0,19,4,0,6,12,5,0,0,0,0,22796,8.6,27268,314,-1415,-1874
3478911184,0,0,20,5,0,4,15,3,0,0,0,0,20709,8.6,25994,244,-3284,-2682,1,1,25,2,1,15,4,7,3,2,1,0,23993,8.8,28676,293,3284,2682
3478678960,0,0,19,1,0,7,11,6,0,0,0,0,23037,8.8,27197,329,-2433,-2873,1,1,18,2,1,11,7,11,3,2,1,0,25470,9.4,30070,312,2433,2873
3475671289,0,1,16,4,1,8,12,9,1,1,0,1,24483,8.4,25611,280,1361,-1265,1,0,19,1,0,12,8,19,2,1,1,0,23122,8.8,26876,264,-1361,1265
3475627164,0,1,16,3,0,14,6,18,1,1,0,0,25566,9,28779,260,3176,1857,1,0,23,1,1,6,14,4,1,0,1,0,22390,9,26922,326,-3176,-1857
3468866844,0,1,17,4,1,8,6,10,0,0,0,1,24810,9.2,28673,340,3482,2837,1,0,22,1,0,6,8,6,1,1,0,0,21328,8.4,25836,306,-3482,-2837
3468860378,0,0,18,7,0,13,6,10,2,1,1,1,26339,9.4,30556,317,4221,4078,1,1,21,2,1,6,13,6,1,1,0,0,22118,8.4,26478,297,-4221,-4078
3468793699,0,0,16,1,0,12,13,9,0,0,0,0,24508,9.2,29288,274,-920,-54,1,1,14,2,1,13,12,10,1,1,0,0,25428,9.2,29342,314,920,54
3455299110,1,1,22,4,1,14,6,12,2,1,1,1,27437,9.6,31304,315,5810,5055,0,0,17,2,0,6,14,7,1,1,0,0,21627,8.8,26249,292,-5810,-5055
3455314534,0,0,15,4,0,11,16,17,0,0,0,0,22900,8.6,25724,237,-2749,-1509,1,1,21,1,1,16,11,27,2,1,1,0,25649,9,27233,241,2749,1509
3455281052,0,0,20,7,0,4,4,3,2,1,1,1,23189,9,28599,320,4178,1795,1,1,20,1,1,4,4,3,1,1,0,0,19011,8.8,26804,187,-4178,-1795
3454497659,0,1,18,2,1,17,20,12,0,0,0,2,28080,9,28514,275,1656,-558,1,0,18,2,0,20,17,13,1,1,0,0,26424,9,29072,237,-1656,558
3454488330,0,1,20,4,0,16,9,14,2,1,1,3,27553,9,29276,236,5448,5683,1,0,17,3,1,9,16,13,1,1,0,0,22105,8,23593,226,-5448,-5683
3454187825,1,1,14,3,1,11,5,15,2,1,1,0,24761,9.4,30453,280,4036,4529,0,0,19,1,0,5,11,9,0,0,0,0,20725,8.6,25924,271,-4036,-4529
3454184322,1,0,19,6,1,6,12,8,0,0,0,0,20826,8.6,25841,237,-3657,-3779,0,1,23,7,0,12,6,6,1,1,0,0,24483,9.2,29620,316,3657,3779
3454098520,0,1,19,6,0,4,8,2,0,0,0,1,22753,8.8,27506,335,467,-840,1,0,22,4,1,8,4,9,1,1,0,0,22286,9,28346,264,-467,840
3427244795,1,0,19,2,0,7,9,10,0,0,0,0,21646,8.6,26476,248,-3140,-2183,0,1,23,3,1,9,7,14,1,1,0,1,24786,9,28659,305,3140,2183
3427200956,1,0,20,3,0,6,9,8,0,0,0,0,21427,8.8,27233,298,-2915,-1381,0,1,22,4,1,9,6,9,1,1,0,0,24342,8.8,28614,313,2915,1381
3427173708,0,1,18,3,1,5,7,4,2,2,0,0,22473,9.2,28954,316,-231,1009,1,0,21,1,0,7,5,6,0,0,0,0,22704,9,27945,304,231,-1009
3427097130,0,0,18,6,0,2,9,2,1,1,0,1,21382,8.8,27214,275,-2449,147,1,1,25,5,1,9,2,14,1,0,1,1,23831,8.8,27067,292,2449,-147
3413718621,1,1,21,6,0,10,10,7,0,0,0,1,25018,9.4,29682,329,1053,1970,0,0,17,4,1,10,10,13,0,0,0,0,23965,8.8,27712,298,-1053,-1970
3413631829,0,0,18,4,1,3,11,4,0,0,0,0,21002,8.4,25317,309,-3008,-4893,1,1,26,1,0,11,3,6,1,1,0,1,24010,9.2,30210,310,3008,4893
3413571167,1,0,25,1,1,12,9,14,2,1,1,0,24218,8.6,25429,273,-631,-3575,0,1,20,5,0,9,12,11,0,0,0,1,24849,9,29004,307,631,3575
3413239480,0,1,24,12,1,3,3,6,1,1,0,0,21748,9.2,27706,362,588,-59,1,0,28,1,0,3,3,3,1,1,0,0,21160,9,27765,330,-588,59
3412323073,1,1,21,2,0,8,5,6,1,1,0,0,21550,8.4,25128,247,423,-822,0,0,17,7,1,5,8,6,0,0,0,0,21127,8.4,25950,310,-423,822
3412214864,0,1,17,3,0,11,9,10,3,2,1,4,28956,9.4,30656,309,7239,5585,1,0,15,1,1,9,11,11,0,0,0,0,21717,8,25071,226,-7239,-5585
3401599179,0,1,12,0,0,8,6,5,2,1,1,9,27359,8.4,24910,269,11255,12616,1,0,3,0,1,6,8,12,0,0,0,0,16104,5,12294,117,-11255,-12616
3401564374,1,0,22,1,0,4,6,5,0,0,0,0,21667,9,28379,329,-448,47,0,1,18,3,1,6,4,4,2,1,1,0,22115,9.2,28332,268,448,-47
3401454838,1,1,22,3,0,8,5,5,1,1,0,1,24517,9.2,29920,322,1906,1428,0,0,17,3,1,5,8,2,1,0,1,0,22611,9,28492,325,-1906,-1428
3397736404,1,0,21,2,0,9,7,12,0,0,0,0,22126,8.8,26216,269,-68,-832,0,1,22,4,1,7,9,5,3,2,1,0,22194,8.8,27048,288,68,832
3397720527,1,0,22,4,0,9,16,8,0,0,0,0,22916,8.8,27005,260,-2204,-1477,0,1,21,3,1,16,9,12,1,1,0,1,25120,8.8,28482,224,2204,1477
3397594407,1,1,20,1,0,8,7,10,1,1,0,1,20238,8.2,24693,239,-3085,-1864,0,0,19,4,1,7,8,10,0,0,0,0,23323,8.8,26557,271,3085,1864
3397469116,0,1,19,5,0,14,5,10,1,0,1,3,28615,9.8,31779,351,8169,6328,1,0,20,1,1,5,14,2,0,0,0,0,20446,8.4,25451,272,-8169,-6328
3397440863,0,0,19,2,1,9,12,8,1,0,1,0,21803,8.6,25629,227,-2710,-1841,1,1,21,1,0,12,9,12,2,2,0,0,24513,9,27470,261,2710,1841
3396372719,0,1,20,5,1,15,8,12,1,0,1,1,27003,8.8,27346,316,5123,2737,1,0,18,2,0,8,15,7,1,1,0,0,21880,8.2,24609,273,-5123,-2737
3396329084,0,1,25,5,1,13,1,22,3,2,1,1,26961,9.4,30779,307,6750,4857,1,0,22,5,0,1,13,1,0,0,0,0,20211,8.8,25922,309,-6750,-4857
3396343607,1,1,25,4,1,12,7,8,2,1,1,2,25648,9.2,29747,288,3780,2398,0,0,21,6,0,7,12,4,0,0,0,0,21868,9,27349,267,-3780,-2398
3394861190,0,1,16,1,1,8,3,5,1,1,0,1,21689,8.8,27043,224,3348,378,1,0,14,0,0,3,8,1,0,0,0,0,18341,8.8,26665,261,-3348,-378
3394158253,0,0,16,3,1,11,13,10,1,1,0,1,24112,9,28436,288,-787,-1098,1,1,20,0,0,13,11,13,2,1,1,0,24899,9.2,29534,299,787,1098
3394142024,0,1,21,1,1,11,9,11,1,1,0,0,24652,8.8,27945,272,2100,445,1,0,20,0,0,9,11,8,0,0,0,0,22552,9,27500,297,-2100,-445
3394092090,0,0,14,8,1,11,6,13,2,1,1,0,24985,9,29076,294,3191,1574,1,1,21,0,0,6,11,4,0,0,0,0,21794,8.8,27502,324,-3191,-1574
3393500871,1,1,27,2,1,16,6,13,1,1,0,1,27691,9.4,30031,319,7037,4666,0,0,18,5,0,6,16,5,0,0,0,0,20654,8.6,25365,219,-7037,-4666
3393465703,0,1,19,4,0,5,6,4,2,1,1,0,22494,8.8,28241,323,1303,1460,1,0,24,3,1,6,5,6,1,1,0,0,21191,8.8,26781,282,-1303,-1460
3393422495,1,0,25,1,0,7,15,8,2,2,0,0,23103,8.6,25556,308,-2878,-2361,0,1,21,4,1,15,7,22,1,0,1,1,25981,8.8,27917,230,2878,2361
3393346066,0,1,22,2,1,14,8,12,1,0,1,1,27429,9,28538,306,5324,2453,1,0,22,3,0,8,14,15,2,2,0,0,22105,8.6,26085,253,-5324,-2453
3392964419,1,0,26,3,1,7,3,5,0,0,0,1,23689,9.2,29548,326,1417,848,0,1,23,4,0,3,7,4,1,1,0,0,22272,9,28700,341,-1417,-848
3392929735,1,0,21,2,0,1,12,0,0,0,0,0,18524,8.4,24068,259,-10618,-8151,0,1,19,3,1,12,1,9,3,2,1,3,29142,9.8,32219,349,10618,8151
3392488400,1,0,19,3,0,9,8,12,1,1,0,0,22037,9,28009,259,-1357,-560,0,1,19,2,1,8,9,7,0,0,0,1,23394,9,28569,294,1357,560
3392441459,1,1,25,4,1,9,4,5,1,1,0,2,25372,9,29911,324,5937,2682,0,0,16,3,0,4,9,5,0,0,0,0,19435,8.6,27229,205,-5937,-2682
3392363126,1,1,29,5,1,6,5,5,1,0,1,0,22051,9,27044,303,667,65,0,0,20,8,0,5,6,6,2,2,0,0,21384,8.8,26979,269,-667,-65
3392307372,0,0,15,4,0,10,8,8,0,0,0,1,21821,8.8,27270,237,-1721,-1267,1,1,27,1,1,8,10,7,2,1,1,0,23542,9.2,28537,270,1721,1267
3391801429,0,0,27,6,0,7,3,6,1,1,0,0,23885,9.4,30621,363,1766,1666,1,1,25,4,1,3,7,5,0,0,0,0,22119,9,28955,359,-1766,-1666
3391765995,0,0,22,2,0,4,9,6,1,1,0,1,21094,8,24113,288,-2898,-2580,1,1,19,5,1,9,4,8,0,0,0,0,23992,8.8,26693,307,2898,2580
3391731049,1,0,23,1,1,7,10,10,1,1,0,0,21003,8.4,24784,238,-5084,-3573,0,1,22,5,0,10,7,15,2,1,1,2,26087,8.8,28357,296,5084,3573
3389495923,1,1,24,4,0,7,8,8,0,0,0,1,23512,9.2,28667,305,2517,2372,0,0,23,5,1,8,7,6,2,2,0,0,20995,8.4,26295,219,-2517,-2372
3389540547,0,1,21,7,0,14,8,7,0,0,0,2,27292,9.6,31492,339,4261,4334,1,0,18,3,1,8,14,8,1,1,0,0,23031,8.8,27158,269,-4261,-4334
3389000717,0,1,25,4,1,10,5,5,3,2,1,0,22864,9.2,29088,289,1854,2369,1,0,21,3,0,5,10,5,0,0,0,0,21010,8.8,26719,301,-1854,-2369
3388968169,0,1,15,3,0,10,9,14,1,1,0,1,25348,8.8,27042,306,3578,1428,1,0,14,2,1,9,10,9,0,0,0,0,21770,8.6,25614,256,-3578,-1428
3388945937,1,0,19,0,0,8,10,9,1,1,0,0,20049,8.2,25153,237,-5822,-3177,0,1,13,4,1,10,8,12,0,0,0,1,25871,9.2,28330,288,5822,3177
3388930331,1,0,25,2,1,11,5,18,1,0,1,0,23750,8.6,25601,277,3236,938,0,1,15,4,0,5,11,4,1,1,0,0,20514,8.2,24663,283,-3236,-938
3388865647,0,1,19,3,0,10,16,9,2,1,1,1,24222,8.8,28385,270,-2776,-96,1,0,22,4,1,16,10,19,1,1,0,1,26998,9.2,28481,283,2776,96
3388911506,0,1,26,4,1,12,4,13,2,1,1,2,26242,9,27911,309,5986,4049,1,0,19,3,0,4,12,12,1,1,0,0,20256,8.4,23862,233,-5986,-4049
3388806014,1,1,18,2,1,8,8,11,1,1,0,0,23304,9.2,29099,292,699,647,0,0,11,3,0,8,8,4,2,1,1,0,22605,9,28452,267,-699,-647
3387815055,0,0,18,6,1,9,13,8,2,1,1,2,25912,8.8,26463,309,147,-3388,1,1,18,2,0,13,9,14,1,1,0,0,25765,9.4,29851,284,-147,3388
3385968812,1,1,11,3,0,8,10,5,1,1,0,0,23154,8.8,27429,276,-354,338,0,0,18,2,1,10,8,9,0,0,0,0,23508,8.6,27091,268,354,-338
3384696143,1,1,26,2,1,8,9,8,1,1,0,1,23190,9.2,28398,280,1301,111,0,0,22,6,0,9,8,5,2,1,1,0,21889,9,28287,259,-1301,-111
3384618181,0,1,18,3,1,17,14,19,1,1,0,0,27810,9.6,30736,281,2791,1951,1,0,22,2,0,14,17,16,1,1,0,0,25019,9.2,28785,265,-2791,-1951
3384614038,0,1,19,7,1,14,6,16,2,2,0,0,24896,9,27622,263,3343,3018,1,0,24,1,0,6,14,5,0,0,0,0,21553,8.2,24604,254,-3343,-3018
3384586530,1,0,16,2,1,8,4,12,2,1,1,0,23307,8.8,27944,301,1414,173,0,1,21,2,0,4,8,5,0,0,0,0,21893,9,27771,344,-1414,-173
3384507983,1,1,17,4,0,10,14,13,0,0,0,0,23560,8.6,26203,305,-3159,-1199,0,0,25,5,1,14,10,16,3,2,1,1,26719,8.8,27402,290,3159,1199
3383561347,0,0,24,2,1,7,10,7,1,1,0,0,20937,8.8,26754,238,-1952,-1891,1,1,20,3,0,10,7,8,0,0,0,0,22889,9.2,28645,306,1952,1891
3382337489,1,0,21,2,0,7,3,7,1,1,0,0,23566,9.2,29000,338,1981,2647,0,1,22,3,1,3,7,6,2,1,1,0,21585,8.6,26353,344,-1981,-2647
3379803743,0,1,15,2,1,7,7,6,2,1,1,1,23186,9.2,28290,320,-304,-1783,1,0,17,0,0,7,7,10,0,0,0,1,23490,9.4,30073,283,304,1783
3379746374,1,0,17,3,0,4,9,8,1,0,1,1,20064,8.2,25128,271,-5048,-3879,0,1,20,2,1,9,4,11,1,1,0,0,25112,9,29007,296,5048,3879
3379222098,0,0,23,5,0,4,11,1,0,0,0,1,21735,8.6,27188,315,-2220,-277,1,1,24,6,1,11,4,16,2,2,0,0,23955,8.8,27465,281,2220,277
3379175177,0,0,13,2,0,10,8,10,1,1,0,0,24155,8.8,27546,278,1479,1425,1,1,22,4,1,8,10,9,1,1,0,0,22676,8.8,26121,321,-1479,-1425
3374650783,0,1,17,2,1,6,6,2,1,1,0,0,20409,8.6,26303,262,-457,520,1,0,19,1,0,6,6,9,1,1,0,0,20866,8.4,25783,275,457,-520
3374579495,0,0,20,1,1,8,8,8,2,1,1,1,23198,9.2,27869,320,1072,-395,1,1,15,2,0,8,8,10,1,1,0,0,22126,9,28264,270,-1072,395
3374541679,1,1,14,2,0,6,11,6,0,0,0,1,22535,8.8,27759,282,-1252,-2322,0,0,21,3,1,11,6,13,1,1,0,0,23787,9.4,30081,260,1252,2322
3373345171,0,0,21,2,0,5,13,4,1,1,0,0,20282,8.2,24138,266,-4493,-5884,1,1,24,1,1,13,5,9,1,1,0,0,24775,9.2,30022,327,4493,5884
3373273525,0,1,21,3,1,13,6,9,3,2,1,1,26927,9.4,30006,342,6286,3559,1,0,18,1,0,6,13,3,0,0,0,0,20641,8.6,26447,305,-6286,-3559
3373235371,1,1,21,3,1,16,5,15,1,1,0,0,25580,9.2,29662,310,4475,3539,0,0,27,7,0,5,16,8,0,0,0,0,21105,8.6,26123,286,-4475,-3539
3371622560,0,1,18,6,1,10,10,6,0,0,0,1,25214,8.6,26773,301,2935,1486,1,0,23,3,0,10,10,13,0,0,0,0,22279,8.6,25287,245,-2935,-1486
3371516238,0,1,18,3,0,6,11,5,1,0,1,2,23246,8.8,27418,277,-967,-686,1,0,24,2,1,11,6,13,1,1,0,0,24213,9,28104,293,967,686
3370899452,1,1,18,4,1,15,9,26,0,0,0,0,26003,9.2,28240,298,4177,4101,0,0,21,3,0,9,15,5,1,1,0,0,21826,8,24139,239,-4177,-4101
3370875986,1,0,13,1,1,12,13,19,0,0,0,1,25024,8.4,24723,263,-962,-2588,0,1,20,1,0,13,12,15,0,0,0,1,25986,8.8,27311,279,962,2588
3370849295,1,1,19,2,1,11,9,16,0,0,0,0,24849,9.2,29284,314,1000,909,0,0,18,3,0,9,11,9,1,1,0,0,23849,9,28375,284,-1000,-909
3370793776,1,1,24,6,1,13,11,13,1,1,0,0,23589,8.6,26377,217,109,-1084,0,0,18,4,0,11,13,8,0,0,0,0,23480,8.6,27461,275,-109,1084
3369159669,1,0,19,1,1,12,13,9,0,0,0,0,24130,9.2,28388,248,-2729,-1960,0,1,18,2,0,13,12,10,3,2,1,1,26859,9.4,30348,306,2729,1960
3369150536,0,1,20,3,0,13,7,9,0,0,0,1,24191,9.2,28698,266,2521,2054,1,0,17,1,1,7,13,7,1,1,0,0,21670,8.8,26644,252,-2521,-2054
3369112611,1,1,18,2,1,10,7,10,1,1,0,0,24097,9.2,29479,280,3175,3688,0,0,15,1,0,7,10,6,0,0,0,0,20922,8.4,25791,265,-3175,-3688
3369006464,0,0,17,3,1,5,10,4,0,0,0,0,20801,8.2,23792,273,-1731,-3169,1,1,17,2,0,10,5,9,3,2,1,0,22532,9,26961,264,1731,3169
3368979476,0,0,20,4,0,6,11,8,0,0,0,0,21344,8.6,25854,282,-3452,-3413,1,1,17,4,1,11,6,12,1,1,0,0,24796,9.2,29267,291,3452,3413
3368352890,0,1,23,3,0,7,10,6,1,0,1,0,21519,8.8,27846,277,-1750,1844,1,0,19,3,1,10,7,9,1,1,0,0,23269,8.6,26002,267,1750,-1844
3368197401,1,1,14,2,1,16,6,15,3,2,1,3,28455,9.6,30484,324,7477,5115,0,0,19,2,0,6,16,7,0,0,0,0,20978,8.4,25369,231,-7477,-5115
3368171430,0,0,15,4,0,7,12,6,1,1,0,0,20998,8.4,24454,220,-6104,-2237,1,1,21,1,1,12,7,10,1,0,1,3,27102,8.8,26691,281,6104,2237
3368022856,1,0,26,4,1,11,6,6,2,1,1,2,24638,9.2,28476,320,1495,-1628,0,1,21,4,0,6,11,5,1,1,0,0,23143,9.4,30104,321,-1495,1628
3365940387,1,1,19,2,0,10,5,14,1,1,0,0,23877,9.2,28537,292,1976,2833,0,0,16,4,1,5,10,10,1,1,0,0,21901,8.8,25704,313,-1976,-2833
3365833659,0,0,15,3,0,7,20,7,0,0,0,0,21687,9,27301,245,-6189,-2019,1,1,24,0,1,20,7,20,2,2,0,2,27876,9.2,29320,268,6189,2019
3365669277,0,1,21,1,1,12,5,13,2,1,1,1,25447,8.8,27590,271,5194,1838,1,0,17,5,0,5,12,6,0,0,0,0,20253,8.6,25752,245,-5194,-1838
3365721311,0,0,19,2,0,11,17,13,0,0,0,0,24935,8.8,26412,296,-4291,-2435,1,1,16,2,1,17,11,21,1,1,0,2,29226,9,28847,315,4291,2435
3362608512,0,0,10,2,0,7,7,11,0,0,0,0,22675,8.8,27198,320,140,-413,1,1,20,1,1,7,7,8,1,1,0,0,22535,8.8,27611,320,-140,413
3361455599,1,1,26,3,1,11,6,11,0,0,0,2,24354,9,27558,309,3393,591,0,0,20,6,0,6,11,3,1,1,0,0,20961,8.8,26967,244,-3393,-591
3361430791,1,1,17,5,0,7,7,2,0,0,0,0,20964,8.6,26270,289,-2240,-280,0,0,21,7,1,7,7,9,1,1,0,1,23204,8.6,26550,289,2240,280
3361223893,1,1,17,4,0,11,10,9,0,0,0,0,24043,8.8,28702,287,1004,66,0,0,17,3,1,10,11,6,2,2,0,0,23039,9.2,28636,276,-1004,-66
3361107669,0,0,20,4,0,4,6,3,0,0,0,0,20784,8.6,26287,308,-2425,-2535,1,1,27,5,1,6,4,8,2,2,0,1,23209,9,28822,322,2425,2535
3360617239,1,1,19,6,1,13,3,8,0,0,0,1,25540,9,29000,305,4776,3633,0,0,16,6,0,3,13,3,0,0,0,0,20764,8.6,25367,302,-4776,-3633
3360519133,0,0,16,2,1,4,16,5,1,0,1,1,19860,8.6,25480,239,-6965,-4411,1,1,18,1,0,16,4,25,1,1,0,0,26825,9.4,29891,281,6965,4411
3360507540,0,1,30,3,1,9,5,9,2,1,1,1,23529,8.8,27112,290,2308,1317,1,0,21,1,0,5,9,12,1,1,0,0,21221,8.6,25795,254,-2308,-1317
3360429005,1,1,20,7,1,11,6,11,1,1,0,0,25504,9.6,30733,359,1754,2120,0,0,21,4,0,6,11,6,1,0,1,1,23750,9,28613,323,-1754,-2120
3360327982,0,1,20,3,1,7,7,7,1,1,0,0,23310,9.2,28383,337,3105,1846,1,0,16,0,0,7,7,8,0,0,0,0,20205,8.8,26537,209,-3105,-1846
3360330058,1,1,16,5,1,14,0,17,3,2,1,1,25162,9.2,29102,255,6747,4689,0,0,22,2,0,0,14,0,0,0,0,0,18415,8.2,24413,271,-6747,-4689
3360241563,0,0,23,3,1,2,4,0,1,1,0,0,20377,9.2,28600,296,-1823,-1825,1,1,15,3,0,4,2,1,0,0,0,0,22200,9.4,30425,349,1823,1825
3357436266,0,0,19,4,1,5,15,5,1,0,1,0,20377,8.4,25460,246,-5351,-5268,1,1,18,5,0,15,5,13,1,1,0,0,25728,9.4,30728,296,5351,5268
3357440153,1,1,21,2,1,19,1,13,2,2,0,1,26803,9.4,31020,322,8315,8798,0,0,10,2,0,1,19,1,0,0,0,0,18488,7.8,22222,230,-8315,-8798
3355740263,1,0,13,2,0,4,11,5,0,0,0,0,18879,7.2,20498,221,-11821,-9933,0,1,14,2,1,11,4,10,3,2,1,7,30700,9.4,30431,290,11821,9933
3348767624,1,1,18,0,1,13,7,5,3,2,1,1,25746,9.4,31486,371,4929,3755,0,0,20,0,0,7,13,8,0,0,0,0,20817,8.8,27731,250,-4929,-3755
3348729284,0,1,25,6,0,12,9,8,1,0,1,1,26373,8.8,27502,303,5443,3558,1,0,23,2,1,9,12,7,2,2,0,0,20930,8.4,23944,239,-5443,-3558
3348667574,1,1,18,0,0,17,9,13,1,1,0,2,27545,9.4,30495,272,5184,4581,0,0,14,1,1,9,17,5,0,0,0,0,22361,8.8,25914,257,-5184,-4581
3348223059,1,1,17,3,1,12,8,11,0,0,0,0,24831,9,28280,304,3689,3987,0,0,21,3,0,8,12,9,1,1,0,0,21142,8,24293,257,-3689,-3987
3348185596,0,1,25,6,1,7,1,6,3,2,1,1,23244,9,28255,273,3003,3175,1,0,22,0,0,1,7,3,0,0,0,0,20241,8.6,25080,318,-3003,-3175
3346133275,1,0,19,5,1,10,14,10,1,0,1,2,24546,8.8,26823,293,-3333,-4057,0,1,24,5,0,14,10,15,1,1,0,0,27879,9.6,30880,322,3333,4057
3346029362,1,1,19,3,1,24,2,18,1,1,0,2,29377,9.8,32000,305,12720,12593,0,0,21,4,0,2,24,1,0,0,0,0,16657,7.2,19407,216,-12720,-12593
3345918181,0,1,21,1,1,8,12,5,1,0,1,0,23139,9,27297,249,1071,-169,1,0,19,1,0,12,8,17,1,1,0,0,22068,9,27466,209,-1071,169
3345830740,1,0,22,6,0,3,6,5,2,1,1,0,20181,8.4,25465,287,-1825,-3189,0,1,24,2,1,6,3,7,1,1,0,0,22006,9,28654,318,1825,3189
3343271201,1,1,22,5,1,9,4,10,2,1,1,0,22349,8.8,26528,274,2387,1320,0,0,18,8,0,4,9,4,0,0,0,0,19962,8.4,25208,249,-2387,-1320
3343214985,1,1,19,1,1,9,4,11,1,1,0,0,22783,9.2,28903,258,1797,848,0,0,19,1,0,4,9,2,2,1,1,0,20986,8.8,28055,277,-1797,-848
3343117881,0,1,15,4,0,11,17,8,3,2,1,0,26086,9.6,30920,316,262,633,1,0,18,0,1,17,11,11,0,0,0,0,25824,9.4,30287,283,-262,-633
3343038432,1,0,20,1,1,7,10,6,0,0,0,0,22257,8.4,25359,280,-325,-2414,0,1,15,1,0,10,7,10,1,1,0,0,22582,9,27773,232,325,2414
3342946182,1,0,25,2,1,7,4,11,1,1,0,0,22824,8.8,27853,322,1659,593,0,1,20,4,0,4,7,4,1,1,0,0,21165,9,27260,306,-1659,-593
3342648928,0,1,26,5,1,7,2,8,1,1,0,0,22525,9.2,28838,309,1883,1355,1,0,20,2,0,2,7,1,2,1,1,0,20642,8.8,27483,327,-1883,-1355
3342529181,1,0,23,2,1,8,8,7,1,0,1,2,24212,8.8,27917,308,577,1576,0,1,21,5,0,8,8,11,1,1,0,0,23635,8.8,26341,296,-577,-1576
3342522469,0,0,21,5,1,6,17,7,1,0,1,0,22763,8.6,26431,301,-3482,-2549,1,1,21,4,0,17,6,18,1,1,0,0,26245,9.2,28980,275,3482,2549
3342483126,1,0,21,2,0,8,8,8,0,0,0,0,21712,8.4,25141,257,-1795,-3110,0,1,20,3,1,8,8,8,1,1,0,1,23507,9,28251,280,1795,3110
3342437522,0,0,20,5,0,0,10,0,0,0,0,0,19050,8.6,25036,291,-5596,-4105,1,1,19,5,1,10,0,17,1,1,0,0,24646,9.2,29141,326,5596,4105
3340828829,0,1,13,0,1,10,4,5,1,1,0,1,23455,9,28077,280,2901,4055,1,0,14,0,0,4,10,4,0,0,0,0,20554,8.2,24022,257,-2901,-4055
3340832199,0,1,21,2,1,9,5,8,2,1,1,0,23971,9.4,30077,289,3992,3050,1,0,19,1,0,5,9,3,0,0,0,0,19979,8.8,27027,284,-3992,-3050
3340746672,1,0,21,5,0,3,11,3,0,0,0,0,19872,8.4,25269,328,-5922,-5367,0,1,23,2,1,11,3,10,3,2,1,2,25794,9.2,30636,325,5922,5367
3340739749,0,0,16,4,1,7,10,3,0,0,0,1,23772,9.2,28610,312,-405,-1928,1,1,20,0,0,10,7,14,2,2,0,0,24177,9.4,30538,327,405,1928
3340629305,0,0,22,3,0,2,9,0,2,2,0,0,21024,8.8,27175,305,-3372,-761,1,1,21,5,1,9,2,13,1,0,1,1,24396,9,27936,279,3372,761
3340595422,0,0,15,1,0,4,18,1,0,0,0,0,20802,8.2,24166,294,-4814,-7379,1,1,15,0,1,18,4,18,1,1,0,0,25616,9.8,31545,276,4814,7379
3339155718,0,0,17,2,0,11,17,6,2,2,0,0,21783,8.8,26866,234,-7452,-5010,1,1,19,0,1,17,11,12,1,0,1,3,29235,9.4,31876,314,7452,5010
3339068854,1,1,17,1,0,11,6,17,1,1,0,0,22615,9.2,27302,228,1058,-201,0,0,21,2,1,6,11,6,0,0,0,0,21557,8.8,27503,274,-1058,201
3339070033,0,0,16,3,1,5,9,6,0,0,0,0,19913,9,27377,218,-2419,-1374,1,1,18,1,0,9,5,9,3,2,1,0,22332,9,28751,240,2419,1374
3339003252,0,0,24,0,1,7,8,2,0,0,0,0,18940,8.4,25048,247,-3768,-2867,1,1,17,3,0,8,7,8,2,2,0,0,22708,9,27915,254,3768,2867
3334529877,0,0,17,0,0,5,15,6,0,0,0,0,20698,8.2,23877,244,-3843,-3682,1,1,19,1,1,15,5,19,1,1,0,0,24541,8.8,27559,258,3843,3682
3216707769,0,1,17,3,1,8,8,12,2,2,0,1,24814,9,28075,322,2252,-484,1,0,18,0,0,8,8,4,0,0,0,0,22562,9.2,28559,315,-2252,484
3216674879,0,0,20,0,1,4,9,5,0,0,0,1,19605,8,23348,252,-7190,-6369,1,1,19,2,0,9,4,8,1,1,0,1,26795,9,29717,342,7190,6369
3122628643,1,1,21,2,1,12,4,17,0,0,0,0,24075,9,27815,267,3131,1365,0,0,19,3,0,4,12,7,1,1,0,1,20944,8.8,26450,233,-3131,-1365
3122645460,1,0,16,0,0,2,9,3,0,0,0,0,20028,8.4,25322,273,-4152,-4208,0,1,22,5,1,9,2,4,2,2,0,1,24180,9.2,29530,297,4152,4208
3122642527,1,0,20,2,1,6,10,9,0,0,0,0,21130,8.2,25004,269,-4455,-3775,0,1,23,5,0,10,6,10,1,1,0,0,25585,9.2,28779,267,4455,3775
3122620088,1,0,19,4,0,7,13,5,0,0,0,0,19854,8.2,24138,244,-5654,-4217,0,1,22,3,1,13,7,5,1,1,0,1,25508,9,28355,286,5654,4217
3122615574,0,1,26,2,0,10,10,9,2,2,0,0,24069,9.2,29545,287,2908,1336,1,0,16,0,1,10,10,4,0,0,0,0,21161,9,28209,250,-2908,-1336
3122601740,1,0,18,3,1,13,13,8,0,0,0,1,24665,9,27391,278,-188,156,0,1,18,3,0,13,13,9,1,1,0,1,24853,9,27235,209,188,-156
3122589557,0,1,22,2,1,6,5,5,1,0,1,2,22344,8.6,26663,215,1802,-124,1,0,17,2,0,5,6,7,1,1,0,0,20542,8.8,26787,256,-1802,124
3074668230,0,1,21,4,1,15,6,14,1,1,0,1,26976,9.6,30820,307,4851,2485,1,0,25,2,0,6,15,9,1,0,1,1,22125,9,28335,296,-4851,-2485
3073045228,0,0,21,2,0,9,11,9,1,1,0,0,23035,8.8,27177,255,-3304,-3067,1,1,23,5,1,11,9,7,0,0,0,1,26339,9.4,30244,335,3304,3067
3072870087,0,0,19,2,0,6,12,3,0,0,0,0,20306,8.6,25398,262,-4767,-3983,1,1,23,1,1,12,6,12,1,1,0,0,25073,9.2,29381,312,4767,3983
3072452425,0,0,20,4,0,4,12,3,0,0,0,1,21659,8.4,25335,320,-2714,-3595,1,1,27,3,1,12,4,12,2,2,0,0,24373,9.2,28930,270,2714,3595
3072440378,0,0,19,2,0,7,8,5,0,0,0,1,23501,9,27921,318,-2291,-2024,1,1,21,4,1,8,7,9,1,1,0,2,25792,9.2,29945,326,2291,2024
3064605932,1,0,15,1,1,8,0,11,1,1,0,0,22865,9.2,27941,286,2619,1049,0,1,21,2,0,0,8,0,0,0,0,0,20246,8.6,26892,355,-2619,-1049
3061855816,0,1,24,1,1,6,5,12,1,0,1,1,22921,8.6,25813,277,2031,48,1,0,15,3,0,5,6,8,0,0,0,0,20890,8.6,25765,251,-2031,-48
3060924238,0,0,15,1,1,10,17,10,0,0,0,0,20940,8.6,25058,202,-6457,-4189,1,1,18,2,0,17,10,20,0,0,0,1,27397,9.2,29247,291,6457,4189
3060920842,1,1,21,4,0,24,8,18,1,0,1,4,30590,9.4,30957,300,10336,9873,0,0,22,4,1,8,24,7,0,0,0,0,20254,7.6,21084,225,-10336,-9873
2951468742,0,0,15,1,0,8,12,2,0,0,0,1,21398,7.8,24252,309,-5170,-5450,1,1,13,2,1,12,8,19,1,1,0,0,26568,9.2,29702,290,5170,5450
2951466938,0,0,21,3,0,6,12,0,0,0,0,1,20511,8.6,26377,240,-4937,-1576,1,1,18,2,1,12,6,20,1,1,0,1,25448,9,27953,281,4937,1576
2951464949,0,0,24,4,1,11,8,12,2,2,0,2,25688,9,26746,277,1035,-840,1,1,16,2,0,8,11,5,0,0,0,0,24653,8.8,27586,260,-1035,840
2951463419,0,0,15,2,0,8,18,6,0,0,0,1,21435,8.4,25517,255,-9579,-5396,1,1,17,0,1,18,8,19,0,0,0,2,31014,9.4,30913,304,9579,5396
2951462104,0,1,19,2,1,15,11,16,1,1,0,2,27078,9.2,29535,254,1933,2348,1,0,17,2,0,11,15,13,0,0,0,0,25145,8.8,27187,298,-1933,-2348
2951461044,0,0,17,0,0,2,12,4,0,0,0,0,18921,8.2,23107,216,-7897,-6505,1,1,18,2,1,12,2,14,1,1,0,1,26818,9.6,29612,310,7897,6505
2950637262,1,1,21,6,1,18,12,26,2,1,1,2,27818,8.8,27085,257,1639,753,0,0,23,6,0,12,18,20,1,1,0,1,26179,8.8,26332,279,-1639,-753
2950644349,1,0,16,3,1,15,11,15,1,1,0,1,27304,9,28739,292,3126,2189,0,1,15,2,0,11,15,7,0,0,0,0,24178,8.6,26550,275,-3126,-2189
2950633334,1,0,19,8,0,19,10,12,0,0,0,2,28330,9.6,30861,286,3115,4733,0,1,25,7,1,10,19,8,0,0,0,0,25215,8.6,26128,274,-3115,-4733
2950630558,0,1,19,1,1,10,5,8,2,1,1,4,24722,8.8,26587,225,-417,-2024,1,0,19,2,0,5,10,5,0,0,0,1,25139,9,28611,322,417,2024
2950609472,1,0,20,2,1,5,11,4,0,0,0,0,22635,8.8,28173,323,-1574,-993,0,1,22,4,0,11,5,12,1,1,0,0,24209,9.4,29166,305,1574,993
2950608237,1,0,15,2,0,15,11,19,2,2,0,1,26884,9.4,29522,306,-2106,-12,0,1,20,6,1,11,15,10,0,0,0,2,28990,9.2,29534,310,2106,12
2950596991,0,1,18,1,0,8,10,10,1,1,0,0,23407,9,28917,254,-2493,-1250,1,0,15,5,1,10,8,7,0,0,0,1,25900,9.4,30167,324,2493,1250
2950604654,0,0,22,4,0,7,9,4,0,0,0,1,23429,9.4,29000,343,-2026,-573,1,1,19,5,1,9,7,8,0,0,0,0,25455,9.2,29573,290,2026,573
2950612634,1,0,18,2,0,8,11,8,0,0,0,0,24279,9,28135,294,-1931,-1815,0,1,21,3,1,11,8,16,1,1,0,1,26210,9.2,29950,274,1931,1815
2950602134,0,1,20,3,0,19,11,19,0,0,0,3,31086,9.8,32142,326,6566,5615,1,0,15,3,1,11,19,15,0,0,0,0,24520,8.6,26527,281,-6566,-5615
2947450890,1,1,19,1,1,15,7,12,1,1,0,1,24673,9.2,30562,228,1070,1448,0,0,24,2,0,7,15,5,0,0,0,0,23603,9.4,29114,306,-1070,-1448
2947434329,0,0,17,0,0,7,12,6,0,0,0,1,23178,8.8,28272,288,-1545,-3662,1,1,17,1,1,12,7,10,1,1,0,0,24723,9.8,31934,270,1545,3662
2947415196,1,0,18,0,1,12,11,13,1,0,1,0,24478,9.2,28400,271,1707,823,0,1,18,3,0,11,12,5,1,1,0,0,22771,9,27577,259,-1707,-823
2928058753,0,0,20,2,1,6,5,5,0,0,0,0,21437,9,27682,278,722,-166,1,1,16,1,0,5,6,4,0,0,0,0,20715,9,27848,255,-722,166
2928058753,0,0,20,2,1,6,5,5,0,0,0,0,21437,9,27682,278,722,-166,1,1,16,1,0,5,6,4,0,0,0,0,20715,9,27848,255,-722,166
2928008218,0,1,18,2,1,10,11,9,0,0,0,3,26945,8.4,26122,302,2397,-1354,1,0,19,0,0,11,10,13,0,0,0,1,24548,9,27476,229,-2397,1354
2927988108,1,1,15,0,0,12,9,11,0,0,0,0,24514,9.4,30896,280,2614,4233,0,0,13,0,1,9,12,10,1,1,0,0,21900,8.8,26663,239,-2614,-4233
2917796757,1,0,11,0,0,14,10,11,0,0,0,0,23601,9.6,29381,231,684,1291,0,1,12,1,1,10,14,9,0,0,0,0,22917,8.8,28090,254,-684,-1291
2917766996,1,1,18,2,1,11,8,12,0,0,0,2,24690,9,28813,290,2864,2640,0,0,19,3,0,8,11,10,0,0,0,0,21826,8.8,26173,224,-2864,-2640
2917735309,0,0,23,3,0,6,11,6,1,1,0,0,20846,8.6,25718,277,-2300,-2856,1,1,15,3,1,11,6,10,0,0,0,1,23146,9.2,28574,268,2300,2856
2914691410,1,0,23,1,0,8,10,9,0,0,0,0,20715,8.8,27092,216,-1853,-2337,0,1,17,4,1,10,8,7,1,0,1,0,22568,9.4,29429,263,1853,2337
2908706168,1,0,19,1,0,8,13,4,1,1,0,0,21178,8.6,26418,250,-3797,-2014,0,1,16,2,1,13,8,13,0,0,0,1,24975,9,28432,332,3797,2014
2908686314,0,1,21,1,1,14,8,9,0,0,0,0,24473,9.6,31759,292,2907,5233,1,0,15,0,0,8,14,6,1,1,0,0,21566,8.8,26526,277,-2907,-5233
2907015778,0,1,25,3,0,8,9,8,1,1,0,2,25523,9.4,31008,333,2399,1203,1,0,13,1,1,9,8,9,0,0,0,0,23124,9.2,29805,303,-2399,-1203
2900947009,0,0,17,3,0,10,12,7,0,0,0,1,23461,8.8,27391,249,-1132,-776,1,1,16,3,1,12,10,11,0,0,0,1,24593,9,28167,303,1132,776
2900268641,1,1,14,0,1,13,6,17,1,1,0,1,23779,8.8,26687,206,3562,922,0,0,19,0,0,6,13,6,0,0,0,1,20217,8.6,25765,229,-3562,-922
2847468183,0,0,19,4,0,4,12,4,1,1,0,1,20805,8.6,25286,282,-4841,-6709,1,1,20,1,1,12,4,14,1,1,0,1,25646,9.8,31995,324,4841,6709
2847443770,1,1,20,3,1,15,9,15,1,1,0,2,26451,9,27501,297,5321,3664,0,0,24,4,0,9,15,14,0,0,0,0,21130,8.2,23837,238,-5321,-3664
2847435188,0,1,21,4,0,9,12,10,1,1,0,2,23070,8.2,24005,284,-300,-1764,1,0,15,1,1,12,9,17,1,0,1,0,23370,8.6,25769,246,300,1764
2847409791,1,1,21,4,1,17,12,18,1,1,0,1,27444,9.8,31253,338,2801,1616,0,0,21,3,0,12,17,13,0,0,0,0,24643,9.4,29637,265,-2801,-1616
3514104763,0,0,15,6,1,9,9,13,0,0,0,1,24158,9.2,27733,299,-500,-909,1,1,17,3,0,9,9,11,1,1,0,0,24658,9.0,28642,323,500,909
3514037259,0,1,24,7,1,8,2,9,1,0,1,1,25176,9.2,28390,342,5084,1871,1,0,18,3,0,2,8,4,2,2,0,0,20092,8.6,26519,276,-5084,-1871
3514032355,1,1,28,2,1,11,3,7,3,2,1,1,25577,9.2,29834,349,3714,1237,0,0,15,6,0,3,11,2,0,0,0,0,21863,8.8,28597,337,-3714,-1237
3513997742,1,0,19,2,0,7,8,8,1,0,1,0,22504,8.8,27490,305,-1975,-2813,0,1,17,0,1,8,7,5,2,2,0,0,24479,9.6,30303,361,1975,2813
3513971425,1,1,16,6,0,8,8,8,0,0,0,0,23884,9.0,28543,298,5,1,0,0,23,4,1,8,8,7,2,1,1,0,23879,9.2,28542,307,-5,-1
3511660969,0,1,15,6,1,9,13,7,2,1,1,1,23601,8.8,26247,285,-1519,-4258,1,0,24,5,0,13,9,14,1,1,0,0,25120,9.4,30505,305,1519,4258
3511584560,0,0,21,1,0,8,14,4,0,0,0,1,21110,8.2,25039,258,-6331,-3391,1,1,24,3,1,14,8,20,2,2,0,2,27441,9.0,28430,274,6331,3391
3511517002,0,0,20,5,1,10,13,11,1,0,1,1,23857,8.6,25918,252,9,-229,1,1,18,4,0,13,10,17,2,2,0,0,23848,8.6,26147,265,-9,229
3511419722,1,1,25,6,1,13,6,22,1,1,0,0,25396,9.2,28291,308,1284,435,0,0,25,6,0,6,13,4,2,1,1,1,24112,8.8,27856,320,-1284,-435
3507437023,0,1,17,4,1,19,8,19,3,2,1,1,29097,9.4,30228,325,6685,3976,1,0,21,1,0,8,19,7,0,0,0,0,22412,8.6,26252,270,-6685,-3976
3507422179,0,0,20,2,1,10,13,10,1,1,0,1,24367,8.8,28666,323,-1971,-1898,1,1,16,4,0,13,10,18,2,1,1,0,26338,9.4,30564,324,1971,1898
3507386815,1,1,20,2,0,21,7,24,1,1,0,3,29636,9.6,30151,288,7248,4654,0,0,17,2,1,7,21,3,0,0,0,0,22388,8.6,25497,304,-7248,-4654
3507309611,0,0,19,3,0,11,16,7,0,0,0,1,24980,8.8,27902,299,-1116,-2422,1,1,18,6,1,16,11,13,2,2,0,0,26096,9.4,30324,260,1116,2422
3507294356,1,1,20,3,1,19,4,21,2,2,0,2,29046,9.4,30538,306,8125,5237,0,0,20,3,0,4,19,2,0,0,0,0,20921,8.4,25301,284,-8125,-5237
3507245389,0,0,21,4,1,12,15,17,0,0,0,1,25701,8.6,26931,288,141,-2239,1,1,22,2,0,15,12,14,2,2,0,0,25560,9.0,29170,281,-141,2239
3507050645,0,1,22,2,1,6,3,6,3,2,1,2,25216,8.8,26976,325,5250,2261,1,0,19,3,0,3,6,3,0,0,0,1,19966,8.2,24715,252,-5250,-2261
3506995311,1,0,26,2,0,4,7,6,1,1,0,0,21848,9.2,29511,319,-2617,-1443,0,1,12,6,1,7,4,5,2,1,1,1,24465,9.4,30954,320,2617,1443
3506991244,1,0,25,6,0,9,12,12,1,1,0,0,22911,8.8,25174,259,-3479,-5627,0,1,21,4,1,12,9,13,2,1,1,0,26390,9.4,30801,349,3479,5627
3506927519,1,1,21,2,1,23,1,27,3,2,1,3,31951,9.8,32186,334,15016,10125,0,0,15,4,0,1,23,2,0,0,0,0,16935,7.8,22061,213,-15016,-10125
3506894752,1,0,21,4,0,11,25,8,0,0,0,0,23620,8.6,26784,230,-8614,-4624,0,1,20,1,1,25,11,28,2,1,1,2,32234,9.4,31408,310,8614,4624
3506870121,1,0,26,2,0,7,13,7,0,0,0,0,22114,8.4,25868,262,-3844,-4473,0,1,14,5,1,13,7,13,2,2,0,0,25958,9.4,30341,302,3844,4473
3501591985,0,0,18,3,0,6,16,3,2,1,1,0,20811,8.6,26240,232,-4409,-3552,1,1,16,2,1,16,6,14,1,1,0,0,25220,9.2,29792,241,4409,3552
3501527441,0,0,29,6,1,14,12,14,1,0,1,0,24841,9.0,27771,249,-448,-824,1,1,19,5,0,12,14,7,1,1,0,0,25289,9.0,28595,309,448,824
3501511871,0,1,26,4,1,13,15,12,0,0,0,1,26032,8.8,26973,292,486,-798,1,0,24,5,0,15,13,14,3,2,1,0,25546,9.2,27771,243,-486,798
3497913180,1,0,11,3,0,7,11,4,0,0,0,1,23065,8.6,26509,298,-5181,-3925,0,1,19,4,1,11,7,9,3,2,1,3,28246,9.4,30434,382,5181,3925
3497929962,1,1,21,9,1,13,0,12,2,2,0,1,26822,9.2,28484,329,7848,3019,0,0,29,4,0,0,13,0,1,0,1,0,18974,8.6,25465,285,-7848,-3019
3497866572,0,1,17,5,1,9,4,3,1,1,0,0,25183,9.4,30376,351,4635,3199,1,0,19,4,0,4,9,4,1,1,0,0,20548,8.8,27177,284,-4635,-3199
3497880612,1,0,16,1,0,6,11,6,0,0,0,0,21224,8.4,25330,258,-4788,-3548,0,1,17,6,1,11,6,10,2,2,0,1,26012,9.4,28878,264,4788,3548
3497824855,0,0,16,3,1,7,10,2,0,0,0,1,23465,9.0,28515,324,-2426,-2082,1,1,24,2,0,10,7,17,2,1,1,2,25891,9.4,30597,347,2426,2082
3497821359,1,0,16,6,0,12,14,18,1,1,0,0,25593,8.8,27049,273,-515,1140,0,1,26,3,1,14,12,13,2,1,1,1,26108,8.6,25909,240,515,-1140
3497707308,1,1,24,1,0,12,9,7,2,1,1,1,25393,9.2,28976,277,2484,2196,0,0,17,1,1,9,12,7,1,1,0,0,22909,8.8,26780,297,-2484,-2196
3496834626,1,0,21,3,1,6,17,5,1,1,0,0,22215,8.6,26101,284,-6939,-6521,0,1,23,3,0,17,6,16,1,0,1,2,29154,9.8,32622,310,6939,6521
3496819914,1,0,28,4,0,8,7,12,1,1,0,0,24464,9.0,28958,354,-445,-1064,0,1,23,9,1,7,8,6,1,0,1,0,24909,9.2,30022,359,445,1064
3496736461,0,0,18,3,0,5,5,4,1,0,1,0,21857,9.0,27285,289,-691,-390,1,1,19,2,1,5,5,9,2,2,0,0,22548,8.8,27675,338,691,390
3496771803,1,1,23,1,0,9,11,9,1,1,0,0,22769,8.8,26703,268,-4380,-3795,0,0,12,3,1,11,9,14,2,1,1,1,27149,9.4,30498,352,4380,3795
3494713448,0,0,19,5,0,6,11,7,1,0,1,0,21985,8.6,26093,300,-2863,-4908,1,1,21,2,1,11,6,8,2,2,0,1,24848,9.2,31001,289,2863,4908
3494680062,0,1,23,3,1,8,8,5,1,0,1,1,24464,9.2,28477,344,1840,467,1,0,20,2,0,8,8,5,2,2,0,0,22624,9.0,28010,316,-1840,-467
3494664689,0,0,17,6,0,4,7,8,1,1,0,0,21410,8.6,26916,270,-1860,-2062,1,1,24,5,1,7,4,8,1,1,0,0,23270,9.0,28978,336,1860,2062
3494599660,1,1,21,2,0,12,10,16,2,1,1,1,25785,8.6,26390,291,405,-1875,0,0,23,4,1,10,12,9,0,0,0,0,25380,9.2,28265,308,-405,1875
3494547113,1,1,20,3,1,12,5,10,1,1,0,0,25706,9.6,30726,348,4170,4149,0,0,17,2,0,5,12,7,2,1,1,0,21536,8.6,26577,267,-4170,-4149
3494502844,1,0,25,2,0,1,12,1,0,0,0,1,18892,8.6,24941,272,-8759,-3669,0,1,21,5,1,12,1,13,3,2,1,1,27651,8.8,28610,340,8759,3669
3494470270,1,0,28,7,1,12,13,19,0,0,0,0,22709,8.4,25228,225,-3246,-1272,0,1,21,8,0,13,12,17,2,2,0,1,25955,8.8,26500,291,3246,1272
3494463137,1,1,20,5,1,9,14,7,0,0,0,0,23552,9.0,27021,290,-3960,-3372,0,0,22,7,0,14,9,16,1,1,0,0,27512,9.4,30393,344,3960,3372
3494400507,1,1,23,8,1,15,6,18,1,1,0,0,25397,9.0,29590,278,2975,2880,0,0,21,2,0,6,15,9,0,0,0,0,22422,8.8,26710,302,-2975,-2880
3492557312,0,0,25,2,1,4,3,4,1,0,1,1,21242,8.6,25137,262,-34,-2290,1,1,25,6,0,3,4,5,1,1,0,0,21276,8.8,27427,332,34,2290
3492570109,1,1,29,0,1,4,0,7,3,2,1,0,22564,9.4,29729,349,2429,1695,0,0,15,3,0,0,4,0,0,0,0,0,20135,8.8,28034,315,-2429,-1695
3492462926,0,0,26,4,1,3,10,2,0,0,0,0,20858,8.6,26008,323,-2147,-2426,1,1,23,3,0,10,3,10,1,1,0,0,23005,9.2,28434,295,2147,2426
